1111111111111111111111111111111111
1000000000000000000000000000000001
10P000D0000111111111000000C0000001
10000000000000000000D0000D00000001
10000C0000000000000011111111100001
1000000000011111111100000000000001
1000000000000000000000000D00000001
1000000000011111111100000000000001
100000000C00000000000D000000000001
1000000000000000000000111001111001
100000000D000000000000000000000001
1000000000001111111110000000000001
1000000000000000000C000000D0000001
1000111111110000000000000000000001
1000000000000000000011111111100001
10000011100011100000000000000C0001
1000000000000000000011100011100001
1000000C00111001110000000000000E01
1000000000000000000000000000000001
1111111111111111111111111111111111